Eine	ART.Indef.Nom.Sg.Fem
Erklärung	N.Reg.Nom.Sg.Fem
ist	VFIN.Sein.3.Sg.Pres.Ind
besonders	ADV
dann	ADV
förderlich	ADJD.Pos
,	SYM.Pun.Comma
wenn	CONJ.SubFin.-
sie	PRO.Pers.Subst.3.Nom.Sg.Fem
von	APPR.Dat
einem	ART.Indef.Dat.Sg.Masc
Schüler	N.Reg.Dat.Sg.Masc
verstanden	VPP.Full.Psp
wird	VFIN.Aux.3.Sg.Pres.Ind
.	SYM.Pun.Sent
Dabei	PROADV.Dem
sollte	VFIN.Mod.3.Sg.Past.Ind
man	PRO.Indef.Subst.-.Nom.Sg.*
darauf	PROADV.Dem
achten	VINF.Full.-
,	SYM.Pun.Comma
sich	PRO.Refl.Subst.3.Acc.Sg.*
an	APPR.An
Prinzipien	N.Reg.Acc.Pl.Neut
zu	PART.Zu
orientieren	VINF.Full.-
.	SYM.Pun.Sent
Ein	ART.Indef.Nom.Sg.Neut
Prinzip	N.Reg.Nom.Sg.Neut
ist	VFIN.Sein.3.Sg.Pres.Ind
eine	ART.Indef.Nom.Sg.Fem
feste	ADJA.Pos.Nom.Sg.Fem
Regel	N.Reg.Nom.Sg.Fem
,	SYM.Pun.Comma
die	PRO.Rel.Subst.-.Acc.Sg.Fem
jemand	PRO.Indef.Subst.-.Nom.Sg.Masc
zur	APPRART.Dat.Sg.Fem
Richtschnur	N.Reg.Dat.Sg.Fem
seines	PRO.Poss.Attr.-.Gen.Sg.Neut
Handelns	N.Reg.Gen.Sg.Neut
macht	VFIN.Full.3.Sg.Pres.Ind
,	SYM.Pun.Comma
durch	APPR.Acc
die	PRO.Rel.Subst.-.Acc.Sg.Fem
er	PRO.Pers.Subst.3.Nom.Sg.Masc
sich	PRO.Refl.Subst.3.Acc.Sg.*
in	APPR.In
seinem	PRO.Poss.Attr.-.Dat.Sg.Neut
Denken	N.Reg.Dat.Sg.Neut
und	CONJ.Coord.-
Handeln	N.Reg.Dat.Sg.Neut
leiten	VINF.Full.-
lässt	VFIN.Full.3.Sg.Pres.Ind
.	SYM.Pun.Sent
Ein	ART.Indef.Nom.Sg.Neut
Prinzip	N.Reg.Nom.Sg.Neut
ist	VFIN.Sein.3.Sg.Pres.Ind
demnach	PROADV.Dem
auch	ADV
ein	ART.Indef.Nom.Sg.Masc
Grundsatz	N.Reg.Nom.Sg.Masc
.	SYM.Pun.Sent

